#  @                #
#                  #
#                  #
#    ######         #
#         #         #
#    #### #        #
#       # #        #
#       # #        #
####################